20 20
100 100

250   250   201   201   201    201    201    201    201    201    201    201    201    201    201    201   201   250   250   250     
250   250   201   250   204    200    250    250    250    250    250    250    250    201    200    200   201   250   250   250
201   201   201   250   207    202    250    207    203    203    251    203    250    201    202    200   201   250   250   250
200   200   250   202   207    202    250    203    251    209    203    203    250    201    202    200   201   250   250   250
202   203   204   207   203    202    250    203    203    203    203    207    250    201    200    202   201   201   201   201
200   207   250   250   202    200    250    209    203    208    204    203    250    201    200    200   200   200   200   200
202   203   250   250   204    200    250    250    250    250    250    250    250    201    202    200   200   200   200   200
203   207   203   207   203    203    207    207    204    207    207    203    207    200    202    202   200   200   200   200
202   200   209   200   200    200    200    200    207    200    200    200    200    201    200    200   200   200   200   200
200   202   207   202   200    200    200    200    207    200    200    200    200    201    200    202   200   200   200   200
202   200   208   208   200    204    207    209    208    250    250    250    202    201    202    200   200   200   200   200
200   209   203   202   203    207    208    200    202    250    250    250    202    201    202    200   200   200   200   200
202   203   200   200   251    210    200    202    200    250    250    250    200    201    200    202   200   200   200   200
200   207   202   209   207    200    202    200    202    250    250    250    200    201    200    200   200   200   200   200
200   208   207   203   208    207    202    200    200    200    202    200    202    201    200    202   200   200   200   200
250   250   250   250   200    200    209    200    251    202    200    200    202    201    202    200   200   200   200   200
250   250   250   250   200    202    209    203    208    202    202    202    200    201    202    202   200   200   200   200
250   250   250   250   250    250    250    250    250    200    200    200    202    201    200    200   200   200   200   200
250   250   250   250   250    250    250    250    250    202    200    200    200    201    202    202   200   200   200   200
250   250   250   250   250    250    250    250    250    250    250    250    250    201    200    200   200   200   200   200