20 20
100 100

306    317   328   339   350   361     301    312    323   334   343   351   396    396    396    396   396   396     396     396   
307    318   329   340   351   311     302    313    324   335   346   357   390    391    391    392   393   394     395     396
308    319   330   341   352   363     303    314    325   336   347   358   331    331    331    331   390   394     330     341
309    320   331   342   353   364     304    315    326   337   348   359   370    309    320    331   307   307     331     342
310    321   332   343   354   311     305    316    327   338   349   360   371    310    321    332   308   308     332     450
311    371   371   371   371   371     306    317    328   339   350   361   372    311    322    333   309   311     333     450
307    318   329   340   351   371     307    318    329   371   371   361   373    250    250    329   310   312     329     341
308    319   330   341   352   369     308    319    371   371   371   362   374    250    250    330   311   322     330     341 
309    320   331   342   353   371     309    320    371   371   371   371   375    309    320    331   307   318     331     342
310    321   332   343   354   371     310    321    332   343   367   371   376    310    321    332   308   319     332     343
311    322   333   344   355   371     371    371    371   371   371   371   377    311    322    333   309   320     333     344 
306    317   334   341   342   343     302    313    346   346   346   371   368    306    317    334   310   321     323     341
301    312   323   323   343   323     303    314    325   336   347   371   369    301    312    323   311   322     324     323
302    313   324   335   346   357     304    315    326   337   348   371   370    302    313    324   306   317     325     335
303    314   325   336   347   358     305    316    327   338   349   371   353    303    314    325   301   312     326     336
304    315   326   337   348   359     306    317    328   339   350   371   351    304    315    326   302   313     326     337
305    316   327   338   349   360     307    318    329   340   351   371   354    305    316    327   303   314     327     338
316    320   328   339   350   361     301    312    323   334   343   371   333    346    323    332   333   334     335     338
371    371   371   371   371   371     371    371    371   371   371   371   307    347    343    334   366   341     337     340
318    321   329   340   351   363     302    313    324   335   346   357   334    357    324    331   344   344     330     371