20 20
100 100

1    13   24    34    46     2     1    68     0     0     0     0    0    0    1   13   135   101     117     125
2    14   25    35    46    70     1    71     0     0     0     0    0    0    2   13   135   102     118     126
3    15   26    36    47    58    68    81    83    87    88     41  47    0    3   15   27    103     119     127
4    16   27    37    48    59    70    82    84     0    89     42  48    0    4   16   28    104     120     128
5    17   28    38    49    60    71     0    85     0    90     43  49    0    5   17   68      0       0     129
6    18   28    39    50    61    72     0    86    92    91     44  50    0    6   18   30      0       0     130
8    19   68    40    51    63    73     0     0    34     0     0    0    0    7   19   81      0       0       0
7    20   31    41    52    63    74    74    25    68    34    24   53    0    8   20   82      0       0       0
9    21   32    42    53    64    75     0    14    68     0     0    0    0    9   21   68      0       0       0 
10   22    0    43    54    66    76     3    15    26     0     0   63    0   10   22   71      0       0       0
11   23    0    44    55    66    77     4    68    71    58    51    0    0   11   23    0      0       0       0
12   24    0     0     0     0     0     0     0    70     0    63    0    0   12   24   0       0       0       0 
0    32   51    53     0    53     0    13    25    68     0     0   51   63    0   0    0       0       0       0
0    63   53    51    51     0    71    49    49    49    63     0    0    0   51   0   63       0       0       0
0    13    0    53     0    63    68    63     0     0     0    53    0   53    0  51    0      51       0       0
53   32   63    51     0     0     0     0    63    53    51     0   53   63   63   0    0       0      63       0
0    51    0    63    53    51    63     0     0     0     0    63   51    0    0   0   63       0       0       0
63    0   63     0     0     0    51    63    51    63    63     0    0   51    0  51    0      63       0       0
0     0    0    53    51     0    63     0     0     0     0    51   63    0   53  63   63      0      51       0
63   63    0     0     0    51    53    63    63    63    63     0    0    0    0   0    0       0       0       0