20 20
500 500
1012 1012 1012 1012 1012 1040 1012 1012 1020 1021 1023 1012 1012 1012 1012 1012 1012 1012 1012 1012
1012 1040 1012 1040 1012 1012 1012 1012 1028 1029 1031 1012 1012 1012 1012 1012 1012 1012 1012 1012
1227 1228 1012 1060 1061 1062 1012 1012 1036 1037 1039 1012 1012 1012 1012 1012 1012 1012 1012 1012
1245 1234 1242 1068 1069 1070 1012 1012 1012 1012 1012 1012 1012 1012 1012 1012 1012 1012 1012 1012
1262 1258 1242 1076 1077 1078 1012 1012 1012 1012 1012 1012 1012 1012 1012 1012 1012 1012 1012 1012
1262 1258 1230 1227 1227 1228 1012 1012 1012 1012 1012 1012 1012 1012 1012 1012 1012 1012 1012 1012
1261 1260 1245 1245 1245 1234 1242 1012 1012 1012 1012 1012 1012 1012 1012 1012 1012 1012 1012 1012
1012 1243 1243 1243 1263 1258 1242 1012 1012 1012 1012 1012 1012 1012 1012 1227 1227 1227 1227 1227
1012 1012 1012 1012 1262 1258 1242 1012 1012 1012 1012 1012 1012 1012 1262 1244 1245 1245 1245 1245
1012 1012 1012 1012 1262 1258 1242 1012 1012 1012 1012 1012 1012 1012 1262 1258 1243 1243 1243 1243
1012 1012 1012 1012 1262 1258 1242 1012 1012 1012 1012 1012 1012 1012 1262 1258 1242 1012 1012 1012
1012 1012 1012 1012 1262 1258 1227 1227 1227 1228 1012 1012 1012 1012 1262 1258 1242 1012 1012 1012
1012 1012 1012 1012 1261 1260 1245 1245 1245 1234 1242 1012 1012 1012 1262 1258 1242 1012 1012 1012
1012 1012 1012 1012 1012 1243 1243 1243 1263 1258 1242 1012 1012 1012 1262 1258 1242 1012 1012 1012
1012 1012 1012 1012 1012 1012 1012 1012 1262 1258 1242 1012 1012 1012 1262 1258 1242 1012 1012 1012
1012 1012 1012 1012 1012 1012 1012 1012 1262 1258 1242 1227 1227 1227 1264 1258 1242 1012 1012 1012
1012 1012 1012 1012 1012 1012 1012 1012 1261 1260 1245 1245 1245 1245 1245 1256 1242 1012 1012 1012
1012 1012 1012 1012 1012 1012 1012 1012 1012 1243 1243 1243 1243 1243 1243 1243 1012 1012 1012 1012
1012 1012 1012 1012 1012 1012 1012 1012 1012 1012 1012 1012 1012 1012 1012 1012 1012 1012 1012 1012
1012 1012 1012 1012 1012 1012 1012 1012 1012 1012 1012 1012 1012 1012 1012 1012 1012 1012 1012 1012