20 20
150 150

301   312   323   450   450   343   351   301   312   323   334   343   351   450   450   450   450   450   450  450

302   313   324   450   450   344   352   302   313   324   335   346   357   450   450   450   450   450   450  450

450   450   450   450   450   450   450   450   450   325   336   347   358   450   450   450   450   450   450  450

450   450   450   450   450   450   450   450   450   326   337   348   359   450   450   450   450   450   450  450

306   306   329   339   450   450   450   450   450   327   338   349   360   450   450   450   450   450   450  301

307   318   330   340   350   361   450   450   450   450   450   450   450   450   450   450   450   450   302  313

308   319   331   341   351   311   450   450   450   450   450   450   450   450   450   450   450   307   303  314

309   320   332   342   352   363   450   450   450   450   450   450   450   450   450   450   450   308   304  315

310   321   329   343   353   364   301   312   450   450   450   450   450   450   450   450   450   309   305  316

311   318   330   371   354   311   302   313   450   450   450   350   340   330   327   311   321   310   306  317

306   319   331   340   371   371   303   313   450   450   450   351   341   342   328   312   322   311   307  318

301   320   332   341   351   371   304   314   450   450   321   311   301   341   330   313   323   312   308  319

302   321   333   342   352   343   305   315   450   450   322   312   302   342   331   314   324   313   309  320

303   322   334   343   450   450   450   450   450   450   450   450   450   450   450   315   323   366   340  321

304   317   323   344   450   450   450   450   450   450   450   450   450   450   450   316   326   315   375  322

305   312   324   341   450   450   450   450   450   450   450   450   450   450   450   317   327   316   312  323

306   313   325   323   450   450   450   450   450   450   450   450   450   450   450   450   450   450   450  450

307   314   326   335   450   450   450   450   450   450   450   450   450   450   450   450   450   450   450  450

308   315   327   336   450   450   450   450   450   450   450   450   450   450   450   450   450   450   450  450

450   450   450   450   450   450   450   450   450   450   450   450   450   450   450   450   450   450   450  450